111111111111111111
177777777777777771
148888883888888841
111112111111211111
177772777177277771
188882884148288881
112111111111111211
172777771777777271
142888881888888241
111111211112111111
177777277172777771
148888288182888841
112111111111111211
172777777777777271
182888883888888281
111111111111111111
