111111111111111111
177777777777777771
138888888888888841
111111111111111211
177777777777777271
148888888888888241
112111111211111111
172777777277777771
162888888288888841
111111111111111211
177777777777777271
148888888888888251
112111111111111111
172777777777777771
182888888888888831
111111111111111111
