111111111111111111
177777777777777771
183888888884888881
111111112111111211
177777772777777271
148888882888888251
112111111211111111
172777777277777771
162888888288888841
111111121111111211
177777727777777271
148887727788888251
112117828511211111
172717111117277771
182888888888288831
111111111111111111
