111111111111111111
1                1
14      3       41
111211111211111211
1  2 1   2 1   2 1
1  241   241   241
112111121111121111
1 2  1 2   1 2   1
142  142   142   1
111211111211111211
1  2 1   2 1   2 1
1  241   241   241
112111121111121111
1 2    2     2   1
142    2     2  31
111111111111111111
