111111111111111111
1                1
14      3       41
111112111111211111
1    2   1  2    1
1    2  414 2    1
112111111111111211
1 2     1      2 1
142     1      241
111111211112111111
1     2  1 2     1
14    2  1 2    41
112111111111111211
1 2            2 1
1 2     3      2 1
111111111111111111
