111111777777777771
177777777777777771
177777777777777771
111171777777711211
177771111111117271
148888888888888281
112111111111111111
172777777777777771
182888888888888841
111111111111111211
177777777777777271
148888888888888281
112111111111111111
172777777777777771
182888888888888831
111111111111111111
