111111111111111111
177777777777777771
138888888488888841
111111111111111211
177777717777777271
148888818888888241
112111111112111111
172777777712777771
162888888812888841
111111211111111211
177777277777777271
148888288888888241
112111111111211111
172777777777277771
182888888888288831
111111111111111111
