111111111111111111
177777777777777771
148888883777777771
111211111111111211
177277177777777271
168284177777777251
112111111111111211
172777177777777771
162884177777777751
111211111111111211
177277177777777271
148288177777777271
112111111111111111
172777777777777771
182888888888888831
111111111111111111
