111111111111111111
14              41
16      3   1    1
11111111111 111121
14              21
1   1           21
12111 111111111111
12              41
12          1    1
11111111111 111121
14              21
1     1         21
1211111 1111111111
12              41
12      3       51
111111111111111111
