111111111111111111
147777777777777741
168888883888888881
111111111111111121
147777777777777721
188888888888888821
121111111111111111
127777777777777741
128888888888888881
111111111111111121
147777777777777721
188888888888888821
121111111111111111
127777777777777741
128888883888888851
111111111111111111
