111111111111111111
177777774777777771
183888888888888881
111111112111111211
177777772777777271
148888882888888251
112111111211111111
172777777277777771
162888777288888841
111111888111111211
177771121177777271
148887727788888251
112118828811211111
172711111117277771
182888888888288831
111111111111111111
