111111111111111111
1                1
14      3        1
111211111111111211
1  2  1        2 1
16 2 41        251
112111111111111211
1 2   1          1
162  41         51
111211111111111211
1  2  1        2 1
14 2  1        2 1
112111111111111111
1 2              1
1 2             31
111111111111111111
