111111111111111111
1                1
13              41
111111112111111211
1       2      2 1
14      2      2 1
112111111111121111
1 2   1     12   1
142   1     12  41
1111121     111211
1    21     1  2 1
14   21     1  2 1
1121111111111 1111
1 2              1
1 2             31
111111111111111111
