111111111111111111
177777777777777771
188888888377777741
121111111111111111
127777777777777771
128888888888888841
111112111111111111
177772777777777771
148882888888888841
111111111211111111
177777777277777771
148888888288888841
111111111111121111
177777777777727771
148888888888828831
111111111111111111
