111111111111111111
177777777777777771
148888883888888841
111211111211111211
177271777271777271
188241888241888241
112111121111121111
172771727771727771
142881428881428881
111211111211111211
177271777271777271
188241888241888241
112111121111121111
172777727777727771
142888828888828831
111111111111111111
