111111111111111111
1                1
1 3        4     1
111111112111111211
1       2      2 1
14      2      251
112111111211111111
1 2      2       1
162      2      41
111111121111111211
1      2       2 1
14     2       251
11211  2 511211111
1 2 1 11111 2    1
1 2         2   31
111111111111111111
