111111111111111111
1       4        1
1 3              1
111111112111111211
1       2      2 1
14      2      251
112111111211111111
1 2      2       1
162      2      41
111111   111111211
1    11211     2 1
14     2       251
11211  2  11211111
1 2 1111111 2    1
1 2         2   31
111111111111111111
