111111111111111111
177777777777777771
138888888888888841
111111111111111211
177777777777777271
148888888888888281
112111111111111111
172777777777777771
162888888888888881
111111111111111211
177777777777777271
148888788888888281
112111711111111111
172777777777777771
182888888888888831
111111111111111111
