111111111111111111
1                1
1        3      41
121111111111111111
12               1
12              41
111112111111111111
1    2           1
14   2          41
111111111211111111
1        2       1
14       2      41
111111111111121111
1            2   1
14           2  31
111111111111111111
