111111111111111111
1     4          1
13       1      41
11111111 111111211
1              2 1
14     1       241
112111111112111111
1 2       12     1
162       12    41
111111211111111211
1     2        2 1
14    2        241
112111111111211111
1 2         2    1
1 2         2   31
111111111111111111
