111111111111111111
177777777777777771
138888888888888841
111111111111111211
177777777777777271
148888877777888281
112111168888111111
172777111211177771
182888888288888841
111111111111111211
177777777777777271
188888888888888251
112111111111111111
172777777777777771
182888888888888831
111111111111111111
