111111111111111111
1                1
13              41
111111111111111211
1              2 1
14             2 1
112111111111111111
1 2              1
162              1
111111111111111211
1              2 1
14             2 1
112111 11111111111
1 2              1
1 2             31
111111111111111111
