111111111111111111
177777774777777771
183888888888888841
111111112111111211
177777782777777271
148887822788882241
112118222811111111
172711222117777771
182888222888888841
111112111111111211
177772777777777271
148882888888888241
112111111111211111
172777777777277771
182888888888288831
111111111111111111
