111111111111111111
177777777777777771
148888888888888831
112111111111111111
172717777777777771
182814888888888481
121111111211111121
127717777277717721
128418888288418421
112111112111112111
172777772777712771
182888872888412481
111111171111111121
177777777777777721
138888888888888821
111111111111111111
