111111111111111111
1                1
14              31
112111111111111111
1 2 1            1
1 2 14         4 1
121111111211111121
12  1    2   1  21
12 41    2  41 421
112111112111112111
1 2     2    12  1
1 2     2   4124 1
1111111 1111111121
1               21
13              21
111111111111111111
