111111111111111111
1                1
13              41
111111111111111211
1              2 1
14             241
112111111211111111
1 2      2       1
162      2      41
111111111111111211
1              2 1
14             251
112111111111111111
1 2              1
1 2             31
111111111111111111
