111111111111111111
1       4        1
1 3             41
111111211111111211
1     2        2 1
14    22      2241
11211 222 11111111
1 2 1122211      1
1 2   222       41
111112111111111211
1    2         2 1
14   2         241
112111111111211111
1 2         2    1
1 2         2   31
111111111111111111
