111111111111111111
177777777777777771
138888888888888841
111111112111111211
177777772777777271
148888882888888281
112111111111121111
172777167777127771
142888177775128841
111112177777111211
177772167777177271
148882177775178281
112111111111171111
172777777777777771
182888888888888831
111111111111111111
