111111111111111111
14              41
1       3        1
111111111111111121
14              21
1               21
121111111111111111
12              41
12               1
111111111111111121
14              21
1               21
121111111111111111
12              41
12      3        1
111111111111111111
