111111111111111111
147777777777777741
167777773887188881
111111111117111121
147777777777777721
188817888888888821
121117111111111111
127777777777777741
128888888887188881
111111111117111121
147777777777777721
188888178888888821
121111171111111111
127777777777777741
128888883888888851
111111111111111111
