111111111111111111
1                1
13              41
111111111111111211
1              2 1
14             2 1
11211116    111111
1 2   1112111    1
1 2      2      41
111111111111111211
1              2 1
1              251
112111111111111111
1 2              1
1 2             31
111111111111111111
